1111111111111111111111111111111111
1P10000000000000000000000000000001
1000000C0000C000000C0000C000000001
1000000C0000C000000C0000C000000001
10000000000000000000000000000000E1
1111111111111111111111111111111111